–û—Ç–ª–∏—á–Ω–æ üöÄ –í–æ—Ç —Å–ø–∏—Å–æ–∫ —Å–∞–º—ã—Ö –ø–æ–ª–µ–∑–Ω—ã—Ö bash-–∫–æ–º–∞–Ω–¥ –¥–ª—è —Ä–∞–±–æ—Ç—ã –≤ Google Colab (–∏ Jupyter Notebook) —Å –ø–æ—è—Å–Ω–µ–Ω–∏—è–º–∏:

üìÇ –†–∞–±–æ—Ç–∞ —Å —Ñ–∞–π–ª–∞–º–∏ –∏ –ø–∞–ø–∫–∞–º–∏
–ö–æ–º–∞–Ω–¥–∞	–ß—Ç–æ –¥–µ–ª–∞–µ—Ç
!pwd	–ü–æ–∫–∞–∑–∞—Ç—å —Ç–µ–∫—É—â—É—é –ø–∞–ø–∫—É (print working directory).
!ls	–ü–æ–∫–∞–∑–∞—Ç—å —Å–ø–∏—Å–æ–∫ —Ñ–∞–π–ª–æ–≤ –≤ —Ç–µ–∫—É—â–µ–π –ø–∞–ø–∫–µ (list).
!ls -l	–ü–æ–∫–∞–∑–∞—Ç—å —Å–ø–∏—Å–æ–∫ —Ñ–∞–π–ª–æ–≤ —Å –ø–æ–¥—Ä–æ–±–Ω–æ—Å—Ç—è–º–∏ (—Ä–∞–∑–º–µ—Ä, –¥–∞—Ç–∞).
!ls -a	–ü–æ–∫–∞–∑–∞—Ç—å –≤—Å–µ —Ñ–∞–π–ª—ã, –≤–∫–ª—é—á–∞—è —Å–∫—Ä—ã—Ç—ã–µ (–Ω–∞–ø—Ä–∏–º–µ—Ä, .kaggle).
!cd folder_name	–ü–µ—Ä–µ–π—Ç–∏ –≤ –ø–∞–ø–∫—É (–Ω–æ –≤ Colab –ª—É—á—à–µ –∏—Å–ø–æ–ª—å–∑–æ–≤–∞—Ç—å %cd folder_name).
!mkdir new_folder	–°–æ–∑–¥–∞—Ç—å –ø–∞–ø–∫—É new_folder.
!rm file.txt	–£–¥–∞–ª–∏—Ç—å —Ñ–∞–π–ª file.txt.
!rm -r folder	–£–¥–∞–ª–∏—Ç—å –ø–∞–ø–∫—É folder –≤–º–µ—Å—Ç–µ —Å –µ—ë —Å–æ–¥–µ—Ä–∂–∏–º—ã–º.
!cp file1.txt file2.txt	–°–∫–æ–ø–∏—Ä–æ–≤–∞—Ç—å —Ñ–∞–π–ª.
!mv file1.txt folder/	–ü–µ—Ä–µ–º–µ—Å—Ç–∏—Ç—å —Ñ–∞–π–ª –≤ –ø–∞–ø–∫—É (–∏–ª–∏ –ø–µ—Ä–µ–∏–º–µ–Ω–æ–≤–∞—Ç—å).
üì¶ –†–∞–±–æ—Ç–∞ —Å –∞—Ä—Ö–∏–≤–∞–º–∏
–ö–æ–º–∞–Ω–¥–∞	–ß—Ç–æ –¥–µ–ª–∞–µ—Ç
!unzip file.zip	–†–∞—Å–ø–∞–∫–æ–≤–∞—Ç—å zip-–∞—Ä—Ö–∏–≤.
!unzip -q file.zip	–†–∞—Å–ø–∞–∫–æ–≤–∞—Ç—å ‚Äú—Ç–∏—Ö–æ‚Äù (–±–µ–∑ –≤—ã–≤–æ–¥–∞ —Å–ø–∏—Å–∫–∞ —Ñ–∞–π–ª–æ–≤).
!tar -xvf file.tar.gz	–†–∞—Å–ø–∞–∫–æ–≤–∞—Ç—å tar.gz –∞—Ä—Ö–∏–≤.
üåê –ò–Ω—Ç–µ—Ä–Ω–µ—Ç –∏ –∑–∞–≥—Ä—É–∑–∫–∏
–ö–æ–º–∞–Ω–¥–∞	–ß—Ç–æ –¥–µ–ª–∞–µ—Ç
!wget URL	–°–∫–∞—á–∞—Ç—å —Ñ–∞–π–ª –ø–æ —Å—Å—ã–ª–∫–µ.
!curl -O URL	–°–∫–∞—á–∞—Ç—å —Ñ–∞–π–ª (–∞–ª—å—Ç–µ—Ä–Ω–∞—Ç–∏–≤–∞ wget).
!kaggle datasets download -d dataset-name	–°–∫–∞—á–∞—Ç—å –¥–∞—Ç–∞—Å–µ—Ç —Å Kaggle.
‚öôÔ∏è –£–ø—Ä–∞–≤–ª–µ–Ω–∏–µ –±–∏–±–ª–∏–æ—Ç–µ–∫–∞–º–∏
–ö–æ–º–∞–Ω–¥–∞	–ß—Ç–æ –¥–µ–ª–∞–µ—Ç
!pip install package_name	–£—Å—Ç–∞–Ω–æ–≤–∏—Ç—å Python-–±–∏–±–ª–∏–æ—Ç–µ–∫—É.
!pip show package_name	–ü–æ—Å–º–æ—Ç—Ä–µ—Ç—å –∏–Ω—Ñ–æ –æ –±–∏–±–ª–∏–æ—Ç–µ–∫–µ.
!pip list	–ü–æ–∫–∞–∑–∞—Ç—å –≤—Å–µ —É—Å—Ç–∞–Ω–æ–≤–ª–µ–Ω–Ω—ã–µ –±–∏–±–ª–∏–æ—Ç–µ–∫–∏.
üîç –ü—Ä–æ—Å–º–æ—Ç—Ä —Å–æ–¥–µ—Ä–∂–∏–º–æ–≥–æ —Ñ–∞–π–ª–æ–≤
–ö–æ–º–∞–Ω–¥–∞	–ß—Ç–æ –¥–µ–ª–∞–µ—Ç
!head file.txt	–ü–æ–∫–∞–∑–∞—Ç—å –ø–µ—Ä–≤—ã–µ 10 —Å—Ç—Ä–æ–∫ —Ñ–∞–π–ª–∞.
!tail file.txt	–ü–æ–∫–∞–∑–∞—Ç—å –ø–æ—Å–ª–µ–¥–Ω–∏–µ 10 —Å—Ç—Ä–æ–∫ —Ñ–∞–π–ª–∞.
!cat file.txt	–ü–æ–∫–∞–∑–∞—Ç—å –≤–µ—Å—å —Ñ–∞–π–ª.
!wc -l file.txt	–ü–æ—Å—á–∏—Ç–∞—Ç—å –∫–æ–ª–∏—á–µ—Å—Ç–≤–æ —Å—Ç—Ä–æ–∫ –≤ —Ñ–∞–π–ª–µ.
üìå –°–ø–µ—Ü–∏–∞–ª—å–Ω—ã–µ Colab ‚Äú–º–∞–≥–∏–∏‚Äù (—Ä–∞–±–æ—Ç–∞—é—Ç –±–µ–∑ !)
–ö–æ–º–∞–Ω–¥–∞	–ß—Ç–æ –¥–µ–ª–∞–µ—Ç
%cd folder	–ü–µ—Ä–µ–π—Ç–∏ –≤ –ø–∞–ø–∫—É (–≤ –æ—Ç–ª–∏—á–∏–µ –æ—Ç !cd, —Å–æ—Ö—Ä–∞–Ω—è–µ—Ç—Å—è –º–µ–∂–¥—É —è—á–µ–π–∫–∞–º–∏).
%ls	–ê–Ω–∞–ª–æ–≥ !ls.
%time	–ó–∞–º–µ—Ä–∏—Ç—å –≤—Ä–µ–º—è –≤—ã–ø–æ–ª–Ω–µ–Ω–∏—è –æ–¥–Ω–æ–π —Å—Ç—Ä–æ–∫–∏ Python.
%